[ INSTRUKSI ASSEMBLY PROGRAMMING LANGUAGES (MALWARE ACT) ]
----------------------------------------------------------

PUSH	: Mendorong nilai ke tumpukan 
POP	: Memunculkan nilai dari tumpukan 
CALL	: Menjalankan suatu fungsi 
RET	: Mengembalikan nilai fungsi yang telah selesai 
JMP	: Melompat ke lokasi alamat 
CMP	: Membandingkan dua nilai 
MOV	: Memindahkan data dari satu lokasi ke lokasi lain 
ADD	: Menambahkan nilai 
SUB	: Mengurangi nilai 

------------------------------------------------------------------

EAX	: Digunakan untuk penjumlahan, perkalian, pengembalian 
EBX	: Register generik, digunakan untuk berbagai operasi nilai
ECX	: Digunakan sebagai penghitung
EDX	: Register generik, digunakan untuk berbagai operasi 
EBP	: Digunakan untuk mereferensikan argumen & variabel lokal 
ESP	: Menunjuk ke argumen terakhir di tumpukan 
ESI/EDI	: Digunakan dalam instruksi transfer memori

-------------------------------------------------------------------
